Studentid,Name,Math,Physics,Chemistry,English,Computer,Total,Average,Grade
1,Saksham,85,78,92,88,95,438,87.6,A
2,Ananya,90,82,85,80,87,424,84.8,A
3,Rahul,70,75,80,72,78,375,75.0,B
4,Priya,95,88,90,92,96,461,92.2,A+
5,Aditya,60,65,70,68,72,335,67.0,C
6,Simran,88,90,85,87,89,439,87.8,A
7,Neha,76,70,72,78,75,371,74.2,B
8,Rohan,82,85,88,80,84,419,83.8,A
9,Aanya,91,89,93,90,92,455,91.0,A+
10,Karan,65,60,70,68,66,329,65.8,C
